dteday,season,weekday,workingday,casual,registered,cnt,season_map,week_map,workday_map
2011-01-01,1,6,0,331,654,985,Spring,Saturday,Holiday
2011-01-02,1,0,0,131,670,801,Spring,Sunday,Holiday
2011-01-03,1,1,1,120,1229,1349,Spring,Monday,Work
2011-01-04,1,2,1,108,1454,1562,Spring,Tuesday,Work
2011-01-05,1,3,1,82,1518,1600,Spring,Wednesday,Work
2011-01-06,1,4,1,88,1518,1606,Spring,Thursday,Work
2011-01-07,1,5,1,148,1362,1510,Spring,Friday,Work
2011-01-08,1,6,0,68,891,959,Spring,Saturday,Holiday
2011-01-09,1,0,0,54,768,822,Spring,Sunday,Holiday
2011-01-10,1,1,1,41,1280,1321,Spring,Monday,Work
2011-01-11,1,2,1,43,1220,1263,Spring,Tuesday,Work
2011-01-12,1,3,1,25,1137,1162,Spring,Wednesday,Work
2011-01-13,1,4,1,38,1368,1406,Spring,Thursday,Work
2011-01-14,1,5,1,54,1367,1421,Spring,Friday,Work
2011-01-15,1,6,0,222,1026,1248,Spring,Saturday,Holiday
2011-01-16,1,0,0,251,953,1204,Spring,Sunday,Holiday
2011-01-17,1,1,0,117,883,1000,Spring,Monday,Holiday
2011-01-18,1,2,1,9,674,683,Spring,Tuesday,Work
2011-01-19,1,3,1,78,1572,1650,Spring,Wednesday,Work
2011-01-20,1,4,1,83,1844,1927,Spring,Thursday,Work
2011-01-21,1,5,1,75,1468,1543,Spring,Friday,Work
2011-01-22,1,6,0,93,888,981,Spring,Saturday,Holiday
2011-01-23,1,0,0,150,836,986,Spring,Sunday,Holiday
2011-01-24,1,1,1,86,1330,1416,Spring,Monday,Work
2011-01-25,1,2,1,186,1799,1985,Spring,Tuesday,Work
2011-01-26,1,3,1,34,472,506,Spring,Wednesday,Work
2011-01-27,1,4,1,15,416,431,Spring,Thursday,Work
2011-01-28,1,5,1,38,1129,1167,Spring,Friday,Work
2011-01-29,1,6,0,123,975,1098,Spring,Saturday,Holiday
2011-01-30,1,0,0,140,956,1096,Spring,Sunday,Holiday
2011-01-31,1,1,1,42,1459,1501,Spring,Monday,Work
2011-02-01,1,2,1,47,1313,1360,Spring,Tuesday,Work
2011-02-02,1,3,1,72,1454,1526,Spring,Wednesday,Work
2011-02-03,1,4,1,61,1489,1550,Spring,Thursday,Work
2011-02-04,1,5,1,88,1620,1708,Spring,Friday,Work
2011-02-05,1,6,0,100,905,1005,Spring,Saturday,Holiday
2011-02-06,1,0,0,354,1269,1623,Spring,Sunday,Holiday
2011-02-07,1,1,1,120,1592,1712,Spring,Monday,Work
2011-02-08,1,2,1,64,1466,1530,Spring,Tuesday,Work
2011-02-09,1,3,1,53,1552,1605,Spring,Wednesday,Work
2011-02-10,1,4,1,47,1491,1538,Spring,Thursday,Work
2011-02-11,1,5,1,149,1597,1746,Spring,Friday,Work
2011-02-12,1,6,0,288,1184,1472,Spring,Saturday,Holiday
2011-02-13,1,0,0,397,1192,1589,Spring,Sunday,Holiday
2011-02-14,1,1,1,208,1705,1913,Spring,Monday,Work
2011-02-15,1,2,1,140,1675,1815,Spring,Tuesday,Work
2011-02-16,1,3,1,218,1897,2115,Spring,Wednesday,Work
2011-02-17,1,4,1,259,2216,2475,Spring,Thursday,Work
2011-02-18,1,5,1,579,2348,2927,Spring,Friday,Work
2011-02-19,1,6,0,532,1103,1635,Spring,Saturday,Holiday
2011-02-20,1,0,0,639,1173,1812,Spring,Sunday,Holiday
2011-02-21,1,1,0,195,912,1107,Spring,Monday,Holiday
2011-02-22,1,2,1,74,1376,1450,Spring,Tuesday,Work
2011-02-23,1,3,1,139,1778,1917,Spring,Wednesday,Work
2011-02-24,1,4,1,100,1707,1807,Spring,Thursday,Work
2011-02-25,1,5,1,120,1341,1461,Spring,Friday,Work
2011-02-26,1,6,0,424,1545,1969,Spring,Saturday,Holiday
2011-02-27,1,0,0,694,1708,2402,Spring,Sunday,Holiday
2011-02-28,1,1,1,81,1365,1446,Spring,Monday,Work
2011-03-01,1,2,1,137,1714,1851,Spring,Tuesday,Work
2011-03-02,1,3,1,231,1903,2134,Spring,Wednesday,Work
2011-03-03,1,4,1,123,1562,1685,Spring,Thursday,Work
2011-03-04,1,5,1,214,1730,1944,Spring,Friday,Work
2011-03-05,1,6,0,640,1437,2077,Spring,Saturday,Holiday
2011-03-06,1,0,0,114,491,605,Spring,Sunday,Holiday
2011-03-07,1,1,1,244,1628,1872,Spring,Monday,Work
2011-03-08,1,2,1,316,1817,2133,Spring,Tuesday,Work
2011-03-09,1,3,1,191,1700,1891,Spring,Wednesday,Work
2011-03-10,1,4,1,46,577,623,Spring,Thursday,Work
2011-03-11,1,5,1,247,1730,1977,Spring,Friday,Work
2011-03-12,1,6,0,724,1408,2132,Spring,Saturday,Holiday
2011-03-13,1,0,0,982,1435,2417,Spring,Sunday,Holiday
2011-03-14,1,1,1,359,1687,2046,Spring,Monday,Work
2011-03-15,1,2,1,289,1767,2056,Spring,Tuesday,Work
2011-03-16,1,3,1,321,1871,2192,Spring,Wednesday,Work
2011-03-17,1,4,1,424,2320,2744,Spring,Thursday,Work
2011-03-18,1,5,1,884,2355,3239,Spring,Friday,Work
2011-03-19,1,6,0,1424,1693,3117,Spring,Saturday,Holiday
2011-03-20,1,0,0,1047,1424,2471,Spring,Sunday,Holiday
2011-03-21,2,1,1,401,1676,2077,Summer,Monday,Work
2011-03-22,2,2,1,460,2243,2703,Summer,Tuesday,Work
2011-03-23,2,3,1,203,1918,2121,Summer,Wednesday,Work
2011-03-24,2,4,1,166,1699,1865,Summer,Thursday,Work
2011-03-25,2,5,1,300,1910,2210,Summer,Friday,Work
2011-03-26,2,6,0,981,1515,2496,Summer,Saturday,Holiday
2011-03-27,2,0,0,472,1221,1693,Summer,Sunday,Holiday
2011-03-28,2,1,1,222,1806,2028,Summer,Monday,Work
2011-03-29,2,2,1,317,2108,2425,Summer,Tuesday,Work
2011-03-30,2,3,1,168,1368,1536,Summer,Wednesday,Work
2011-03-31,2,4,1,179,1506,1685,Summer,Thursday,Work
2011-04-01,2,5,1,307,1920,2227,Summer,Friday,Work
2011-04-02,2,6,0,898,1354,2252,Summer,Saturday,Holiday
2011-04-03,2,0,0,1651,1598,3249,Summer,Sunday,Holiday
2011-04-04,2,1,1,734,2381,3115,Summer,Monday,Work
2011-04-05,2,2,1,167,1628,1795,Summer,Tuesday,Work
2011-04-06,2,3,1,413,2395,2808,Summer,Wednesday,Work
2011-04-07,2,4,1,571,2570,3141,Summer,Thursday,Work
2011-04-08,2,5,1,172,1299,1471,Summer,Friday,Work
2011-04-09,2,6,0,879,1576,2455,Summer,Saturday,Holiday
2011-04-10,2,0,0,1188,1707,2895,Summer,Sunday,Holiday
2011-04-11,2,1,1,855,2493,3348,Summer,Monday,Work
2011-04-12,2,2,1,257,1777,2034,Summer,Tuesday,Work
2011-04-13,2,3,1,209,1953,2162,Summer,Wednesday,Work
2011-04-14,2,4,1,529,2738,3267,Summer,Thursday,Work
2011-04-15,2,5,0,642,2484,3126,Summer,Friday,Holiday
2011-04-16,2,6,0,121,674,795,Summer,Saturday,Holiday
2011-04-17,2,0,0,1558,2186,3744,Summer,Sunday,Holiday
2011-04-18,2,1,1,669,2760,3429,Summer,Monday,Work
2011-04-19,2,2,1,409,2795,3204,Summer,Tuesday,Work
2011-04-20,2,3,1,613,3331,3944,Summer,Wednesday,Work
2011-04-21,2,4,1,745,3444,4189,Summer,Thursday,Work
2011-04-22,2,5,1,177,1506,1683,Summer,Friday,Work
2011-04-23,2,6,0,1462,2574,4036,Summer,Saturday,Holiday
2011-04-24,2,0,0,1710,2481,4191,Summer,Sunday,Holiday
2011-04-25,2,1,1,773,3300,4073,Summer,Monday,Work
2011-04-26,2,2,1,678,3722,4400,Summer,Tuesday,Work
2011-04-27,2,3,1,547,3325,3872,Summer,Wednesday,Work
2011-04-28,2,4,1,569,3489,4058,Summer,Thursday,Work
2011-04-29,2,5,1,878,3717,4595,Summer,Friday,Work
2011-04-30,2,6,0,1965,3347,5312,Summer,Saturday,Holiday
2011-05-01,2,0,0,1138,2213,3351,Summer,Sunday,Holiday
2011-05-02,2,1,1,847,3554,4401,Summer,Monday,Work
2011-05-03,2,2,1,603,3848,4451,Summer,Tuesday,Work
2011-05-04,2,3,1,255,2378,2633,Summer,Wednesday,Work
2011-05-05,2,4,1,614,3819,4433,Summer,Thursday,Work
2011-05-06,2,5,1,894,3714,4608,Summer,Friday,Work
2011-05-07,2,6,0,1612,3102,4714,Summer,Saturday,Holiday
2011-05-08,2,0,0,1401,2932,4333,Summer,Sunday,Holiday
2011-05-09,2,1,1,664,3698,4362,Summer,Monday,Work
2011-05-10,2,2,1,694,4109,4803,Summer,Tuesday,Work
2011-05-11,2,3,1,550,3632,4182,Summer,Wednesday,Work
2011-05-12,2,4,1,695,4169,4864,Summer,Thursday,Work
2011-05-13,2,5,1,692,3413,4105,Summer,Friday,Work
2011-05-14,2,6,0,902,2507,3409,Summer,Saturday,Holiday
2011-05-15,2,0,0,1582,2971,4553,Summer,Sunday,Holiday
2011-05-16,2,1,1,773,3185,3958,Summer,Monday,Work
2011-05-17,2,2,1,678,3445,4123,Summer,Tuesday,Work
2011-05-18,2,3,1,536,3319,3855,Summer,Wednesday,Work
2011-05-19,2,4,1,735,3840,4575,Summer,Thursday,Work
2011-05-20,2,5,1,909,4008,4917,Summer,Friday,Work
2011-05-21,2,6,0,2258,3547,5805,Summer,Saturday,Holiday
2011-05-22,2,0,0,1576,3084,4660,Summer,Sunday,Holiday
2011-05-23,2,1,1,836,3438,4274,Summer,Monday,Work
2011-05-24,2,2,1,659,3833,4492,Summer,Tuesday,Work
2011-05-25,2,3,1,740,4238,4978,Summer,Wednesday,Work
2011-05-26,2,4,1,758,3919,4677,Summer,Thursday,Work
2011-05-27,2,5,1,871,3808,4679,Summer,Friday,Work
2011-05-28,2,6,0,2001,2757,4758,Summer,Saturday,Holiday
2011-05-29,2,0,0,2355,2433,4788,Summer,Sunday,Holiday
2011-05-30,2,1,0,1549,2549,4098,Summer,Monday,Holiday
2011-05-31,2,2,1,673,3309,3982,Summer,Tuesday,Work
2011-06-01,2,3,1,513,3461,3974,Summer,Wednesday,Work
2011-06-02,2,4,1,736,4232,4968,Summer,Thursday,Work
2011-06-03,2,5,1,898,4414,5312,Summer,Friday,Work
2011-06-04,2,6,0,1869,3473,5342,Summer,Saturday,Holiday
2011-06-05,2,0,0,1685,3221,4906,Summer,Sunday,Holiday
2011-06-06,2,1,1,673,3875,4548,Summer,Monday,Work
2011-06-07,2,2,1,763,4070,4833,Summer,Tuesday,Work
2011-06-08,2,3,1,676,3725,4401,Summer,Wednesday,Work
2011-06-09,2,4,1,563,3352,3915,Summer,Thursday,Work
2011-06-10,2,5,1,815,3771,4586,Summer,Friday,Work
2011-06-11,2,6,0,1729,3237,4966,Summer,Saturday,Holiday
2011-06-12,2,0,0,1467,2993,4460,Summer,Sunday,Holiday
2011-06-13,2,1,1,863,4157,5020,Summer,Monday,Work
2011-06-14,2,2,1,727,4164,4891,Summer,Tuesday,Work
2011-06-15,2,3,1,769,4411,5180,Summer,Wednesday,Work
2011-06-16,2,4,1,545,3222,3767,Summer,Thursday,Work
2011-06-17,2,5,1,863,3981,4844,Summer,Friday,Work
2011-06-18,2,6,0,1807,3312,5119,Summer,Saturday,Holiday
2011-06-19,2,0,0,1639,3105,4744,Summer,Sunday,Holiday
2011-06-20,2,1,1,699,3311,4010,Summer,Monday,Work
2011-06-21,3,2,1,774,4061,4835,Fall,Tuesday,Work
2011-06-22,3,3,1,661,3846,4507,Fall,Wednesday,Work
2011-06-23,3,4,1,746,4044,4790,Fall,Thursday,Work
2011-06-24,3,5,1,969,4022,4991,Fall,Friday,Work
2011-06-25,3,6,0,1782,3420,5202,Fall,Saturday,Holiday
2011-06-26,3,0,0,1920,3385,5305,Fall,Sunday,Holiday
2011-06-27,3,1,1,854,3854,4708,Fall,Monday,Work
2011-06-28,3,2,1,732,3916,4648,Fall,Tuesday,Work
2011-06-29,3,3,1,848,4377,5225,Fall,Wednesday,Work
2011-06-30,3,4,1,1027,4488,5515,Fall,Thursday,Work
2011-07-01,3,5,1,1246,4116,5362,Fall,Friday,Work
2011-07-02,3,6,0,2204,2915,5119,Fall,Saturday,Holiday
2011-07-03,3,0,0,2282,2367,4649,Fall,Sunday,Holiday
2011-07-04,3,1,0,3065,2978,6043,Fall,Monday,Holiday
2011-07-05,3,2,1,1031,3634,4665,Fall,Tuesday,Work
2011-07-06,3,3,1,784,3845,4629,Fall,Wednesday,Work
2011-07-07,3,4,1,754,3838,4592,Fall,Thursday,Work
2011-07-08,3,5,1,692,3348,4040,Fall,Friday,Work
2011-07-09,3,6,0,1988,3348,5336,Fall,Saturday,Holiday
2011-07-10,3,0,0,1743,3138,4881,Fall,Sunday,Holiday
2011-07-11,3,1,1,723,3363,4086,Fall,Monday,Work
2011-07-12,3,2,1,662,3596,4258,Fall,Tuesday,Work
2011-07-13,3,3,1,748,3594,4342,Fall,Wednesday,Work
2011-07-14,3,4,1,888,4196,5084,Fall,Thursday,Work
2011-07-15,3,5,1,1318,4220,5538,Fall,Friday,Work
2011-07-16,3,6,0,2418,3505,5923,Fall,Saturday,Holiday
2011-07-17,3,0,0,2006,3296,5302,Fall,Sunday,Holiday
2011-07-18,3,1,1,841,3617,4458,Fall,Monday,Work
2011-07-19,3,2,1,752,3789,4541,Fall,Tuesday,Work
2011-07-20,3,3,1,644,3688,4332,Fall,Wednesday,Work
2011-07-21,3,4,1,632,3152,3784,Fall,Thursday,Work
2011-07-22,3,5,1,562,2825,3387,Fall,Friday,Work
2011-07-23,3,6,0,987,2298,3285,Fall,Saturday,Holiday
2011-07-24,3,0,0,1050,2556,3606,Fall,Sunday,Holiday
2011-07-25,3,1,1,568,3272,3840,Fall,Monday,Work
2011-07-26,3,2,1,750,3840,4590,Fall,Tuesday,Work
2011-07-27,3,3,1,755,3901,4656,Fall,Wednesday,Work
2011-07-28,3,4,1,606,3784,4390,Fall,Thursday,Work
2011-07-29,3,5,1,670,3176,3846,Fall,Friday,Work
2011-07-30,3,6,0,1559,2916,4475,Fall,Saturday,Holiday
2011-07-31,3,0,0,1524,2778,4302,Fall,Sunday,Holiday
2011-08-01,3,1,1,729,3537,4266,Fall,Monday,Work
2011-08-02,3,2,1,801,4044,4845,Fall,Tuesday,Work
2011-08-03,3,3,1,467,3107,3574,Fall,Wednesday,Work
2011-08-04,3,4,1,799,3777,4576,Fall,Thursday,Work
2011-08-05,3,5,1,1023,3843,4866,Fall,Friday,Work
2011-08-06,3,6,0,1521,2773,4294,Fall,Saturday,Holiday
2011-08-07,3,0,0,1298,2487,3785,Fall,Sunday,Holiday
2011-08-08,3,1,1,846,3480,4326,Fall,Monday,Work
2011-08-09,3,2,1,907,3695,4602,Fall,Tuesday,Work
2011-08-10,3,3,1,884,3896,4780,Fall,Wednesday,Work
2011-08-11,3,4,1,812,3980,4792,Fall,Thursday,Work
2011-08-12,3,5,1,1051,3854,4905,Fall,Friday,Work
2011-08-13,3,6,0,1504,2646,4150,Fall,Saturday,Holiday
2011-08-14,3,0,0,1338,2482,3820,Fall,Sunday,Holiday
2011-08-15,3,1,1,775,3563,4338,Fall,Monday,Work
2011-08-16,3,2,1,721,4004,4725,Fall,Tuesday,Work
2011-08-17,3,3,1,668,4026,4694,Fall,Wednesday,Work
2011-08-18,3,4,1,639,3166,3805,Fall,Thursday,Work
2011-08-19,3,5,1,797,3356,4153,Fall,Friday,Work
2011-08-20,3,6,0,1914,3277,5191,Fall,Saturday,Holiday
2011-08-21,3,0,0,1249,2624,3873,Fall,Sunday,Holiday
2011-08-22,3,1,1,833,3925,4758,Fall,Monday,Work
2011-08-23,3,2,1,1281,4614,5895,Fall,Tuesday,Work
2011-08-24,3,3,1,949,4181,5130,Fall,Wednesday,Work
2011-08-25,3,4,1,435,3107,3542,Fall,Thursday,Work
2011-08-26,3,5,1,768,3893,4661,Fall,Friday,Work
2011-08-27,3,6,0,226,889,1115,Fall,Saturday,Holiday
2011-08-28,3,0,0,1415,2919,4334,Fall,Sunday,Holiday
2011-08-29,3,1,1,729,3905,4634,Fall,Monday,Work
2011-08-30,3,2,1,775,4429,5204,Fall,Tuesday,Work
2011-08-31,3,3,1,688,4370,5058,Fall,Wednesday,Work
2011-09-01,3,4,1,783,4332,5115,Fall,Thursday,Work
2011-09-02,3,5,1,875,3852,4727,Fall,Friday,Work
2011-09-03,3,6,0,1935,2549,4484,Fall,Saturday,Holiday
2011-09-04,3,0,0,2521,2419,4940,Fall,Sunday,Holiday
2011-09-05,3,1,0,1236,2115,3351,Fall,Monday,Holiday
2011-09-06,3,2,1,204,2506,2710,Fall,Tuesday,Work
2011-09-07,3,3,1,118,1878,1996,Fall,Wednesday,Work
2011-09-08,3,4,1,153,1689,1842,Fall,Thursday,Work
2011-09-09,3,5,1,417,3127,3544,Fall,Friday,Work
2011-09-10,3,6,0,1750,3595,5345,Fall,Saturday,Holiday
2011-09-11,3,0,0,1633,3413,5046,Fall,Sunday,Holiday
2011-09-12,3,1,1,690,4023,4713,Fall,Monday,Work
2011-09-13,3,2,1,701,4062,4763,Fall,Tuesday,Work
2011-09-14,3,3,1,647,4138,4785,Fall,Wednesday,Work
2011-09-15,3,4,1,428,3231,3659,Fall,Thursday,Work
2011-09-16,3,5,1,742,4018,4760,Fall,Friday,Work
2011-09-17,3,6,0,1434,3077,4511,Fall,Saturday,Holiday
2011-09-18,3,0,0,1353,2921,4274,Fall,Sunday,Holiday
2011-09-19,3,1,1,691,3848,4539,Fall,Monday,Work
2011-09-20,3,2,1,438,3203,3641,Fall,Tuesday,Work
2011-09-21,3,3,1,539,3813,4352,Fall,Wednesday,Work
2011-09-22,3,4,1,555,4240,4795,Fall,Thursday,Work
2011-09-23,4,5,1,258,2137,2395,Winter,Friday,Work
2011-09-24,4,6,0,1776,3647,5423,Winter,Saturday,Holiday
2011-09-25,4,0,0,1544,3466,5010,Winter,Sunday,Holiday
2011-09-26,4,1,1,684,3946,4630,Winter,Monday,Work
2011-09-27,4,2,1,477,3643,4120,Winter,Tuesday,Work
2011-09-28,4,3,1,480,3427,3907,Winter,Wednesday,Work
2011-09-29,4,4,1,653,4186,4839,Winter,Thursday,Work
2011-09-30,4,5,1,830,4372,5202,Winter,Friday,Work
2011-10-01,4,6,0,480,1949,2429,Winter,Saturday,Holiday
2011-10-02,4,0,0,616,2302,2918,Winter,Sunday,Holiday
2011-10-03,4,1,1,330,3240,3570,Winter,Monday,Work
2011-10-04,4,2,1,486,3970,4456,Winter,Tuesday,Work
2011-10-05,4,3,1,559,4267,4826,Winter,Wednesday,Work
2011-10-06,4,4,1,639,4126,4765,Winter,Thursday,Work
2011-10-07,4,5,1,949,4036,4985,Winter,Friday,Work
2011-10-08,4,6,0,2235,3174,5409,Winter,Saturday,Holiday
2011-10-09,4,0,0,2397,3114,5511,Winter,Sunday,Holiday
2011-10-10,4,1,0,1514,3603,5117,Winter,Monday,Holiday
2011-10-11,4,2,1,667,3896,4563,Winter,Tuesday,Work
2011-10-12,4,3,1,217,2199,2416,Winter,Wednesday,Work
2011-10-13,4,4,1,290,2623,2913,Winter,Thursday,Work
2011-10-14,4,5,1,529,3115,3644,Winter,Friday,Work
2011-10-15,4,6,0,1899,3318,5217,Winter,Saturday,Holiday
2011-10-16,4,0,0,1748,3293,5041,Winter,Sunday,Holiday
2011-10-17,4,1,1,713,3857,4570,Winter,Monday,Work
2011-10-18,4,2,1,637,4111,4748,Winter,Tuesday,Work
2011-10-19,4,3,1,254,2170,2424,Winter,Wednesday,Work
2011-10-20,4,4,1,471,3724,4195,Winter,Thursday,Work
2011-10-21,4,5,1,676,3628,4304,Winter,Friday,Work
2011-10-22,4,6,0,1499,2809,4308,Winter,Saturday,Holiday
2011-10-23,4,0,0,1619,2762,4381,Winter,Sunday,Holiday
2011-10-24,4,1,1,699,3488,4187,Winter,Monday,Work
2011-10-25,4,2,1,695,3992,4687,Winter,Tuesday,Work
2011-10-26,4,3,1,404,3490,3894,Winter,Wednesday,Work
2011-10-27,4,4,1,240,2419,2659,Winter,Thursday,Work
2011-10-28,4,5,1,456,3291,3747,Winter,Friday,Work
2011-10-29,4,6,0,57,570,627,Winter,Saturday,Holiday
2011-10-30,4,0,0,885,2446,3331,Winter,Sunday,Holiday
2011-10-31,4,1,1,362,3307,3669,Winter,Monday,Work
2011-11-01,4,2,1,410,3658,4068,Winter,Tuesday,Work
2011-11-02,4,3,1,370,3816,4186,Winter,Wednesday,Work
2011-11-03,4,4,1,318,3656,3974,Winter,Thursday,Work
2011-11-04,4,5,1,470,3576,4046,Winter,Friday,Work
2011-11-05,4,6,0,1156,2770,3926,Winter,Saturday,Holiday
2011-11-06,4,0,0,952,2697,3649,Winter,Sunday,Holiday
2011-11-07,4,1,1,373,3662,4035,Winter,Monday,Work
2011-11-08,4,2,1,376,3829,4205,Winter,Tuesday,Work
2011-11-09,4,3,1,305,3804,4109,Winter,Wednesday,Work
2011-11-10,4,4,1,190,2743,2933,Winter,Thursday,Work
2011-11-11,4,5,0,440,2928,3368,Winter,Friday,Holiday
2011-11-12,4,6,0,1275,2792,4067,Winter,Saturday,Holiday
2011-11-13,4,0,0,1004,2713,3717,Winter,Sunday,Holiday
2011-11-14,4,1,1,595,3891,4486,Winter,Monday,Work
2011-11-15,4,2,1,449,3746,4195,Winter,Tuesday,Work
2011-11-16,4,3,1,145,1672,1817,Winter,Wednesday,Work
2011-11-17,4,4,1,139,2914,3053,Winter,Thursday,Work
2011-11-18,4,5,1,245,3147,3392,Winter,Friday,Work
2011-11-19,4,6,0,943,2720,3663,Winter,Saturday,Holiday
2011-11-20,4,0,0,787,2733,3520,Winter,Sunday,Holiday
2011-11-21,4,1,1,220,2545,2765,Winter,Monday,Work
2011-11-22,4,2,1,69,1538,1607,Winter,Tuesday,Work
2011-11-23,4,3,1,112,2454,2566,Winter,Wednesday,Work
2011-11-24,4,4,0,560,935,1495,Winter,Thursday,Holiday
2011-11-25,4,5,1,1095,1697,2792,Winter,Friday,Work
2011-11-26,4,6,0,1249,1819,3068,Winter,Saturday,Holiday
2011-11-27,4,0,0,810,2261,3071,Winter,Sunday,Holiday
2011-11-28,4,1,1,253,3614,3867,Winter,Monday,Work
2011-11-29,4,2,1,96,2818,2914,Winter,Tuesday,Work
2011-11-30,4,3,1,188,3425,3613,Winter,Wednesday,Work
2011-12-01,4,4,1,182,3545,3727,Winter,Thursday,Work
2011-12-02,4,5,1,268,3672,3940,Winter,Friday,Work
2011-12-03,4,6,0,706,2908,3614,Winter,Saturday,Holiday
2011-12-04,4,0,0,634,2851,3485,Winter,Sunday,Holiday
2011-12-05,4,1,1,233,3578,3811,Winter,Monday,Work
2011-12-06,4,2,1,126,2468,2594,Winter,Tuesday,Work
2011-12-07,4,3,1,50,655,705,Winter,Wednesday,Work
2011-12-08,4,4,1,150,3172,3322,Winter,Thursday,Work
2011-12-09,4,5,1,261,3359,3620,Winter,Friday,Work
2011-12-10,4,6,0,502,2688,3190,Winter,Saturday,Holiday
2011-12-11,4,0,0,377,2366,2743,Winter,Sunday,Holiday
2011-12-12,4,1,1,143,3167,3310,Winter,Monday,Work
2011-12-13,4,2,1,155,3368,3523,Winter,Tuesday,Work
2011-12-14,4,3,1,178,3562,3740,Winter,Wednesday,Work
2011-12-15,4,4,1,181,3528,3709,Winter,Thursday,Work
2011-12-16,4,5,1,178,3399,3577,Winter,Friday,Work
2011-12-17,4,6,0,275,2464,2739,Winter,Saturday,Holiday
2011-12-18,4,0,0,220,2211,2431,Winter,Sunday,Holiday
2011-12-19,4,1,1,260,3143,3403,Winter,Monday,Work
2011-12-20,4,2,1,216,3534,3750,Winter,Tuesday,Work
2011-12-21,1,3,1,107,2553,2660,Spring,Wednesday,Work
2011-12-22,1,4,1,227,2841,3068,Spring,Thursday,Work
2011-12-23,1,5,1,163,2046,2209,Spring,Friday,Work
2011-12-24,1,6,0,155,856,1011,Spring,Saturday,Holiday
2011-12-25,1,0,0,303,451,754,Spring,Sunday,Holiday
2011-12-26,1,1,0,430,887,1317,Spring,Monday,Holiday
2011-12-27,1,2,1,103,1059,1162,Spring,Tuesday,Work
2011-12-28,1,3,1,255,2047,2302,Spring,Wednesday,Work
2011-12-29,1,4,1,254,2169,2423,Spring,Thursday,Work
2011-12-30,1,5,1,491,2508,2999,Spring,Friday,Work
2011-12-31,1,6,0,665,1820,2485,Spring,Saturday,Holiday
2012-01-01,1,0,0,686,1608,2294,Spring,Sunday,Holiday
2012-01-02,1,1,0,244,1707,1951,Spring,Monday,Holiday
2012-01-03,1,2,1,89,2147,2236,Spring,Tuesday,Work
2012-01-04,1,3,1,95,2273,2368,Spring,Wednesday,Work
2012-01-05,1,4,1,140,3132,3272,Spring,Thursday,Work
2012-01-06,1,5,1,307,3791,4098,Spring,Friday,Work
2012-01-07,1,6,0,1070,3451,4521,Spring,Saturday,Holiday
2012-01-08,1,0,0,599,2826,3425,Spring,Sunday,Holiday
2012-01-09,1,1,1,106,2270,2376,Spring,Monday,Work
2012-01-10,1,2,1,173,3425,3598,Spring,Tuesday,Work
2012-01-11,1,3,1,92,2085,2177,Spring,Wednesday,Work
2012-01-12,1,4,1,269,3828,4097,Spring,Thursday,Work
2012-01-13,1,5,1,174,3040,3214,Spring,Friday,Work
2012-01-14,1,6,0,333,2160,2493,Spring,Saturday,Holiday
2012-01-15,1,0,0,284,2027,2311,Spring,Sunday,Holiday
2012-01-16,1,1,0,217,2081,2298,Spring,Monday,Holiday
2012-01-17,1,2,1,127,2808,2935,Spring,Tuesday,Work
2012-01-18,1,3,1,109,3267,3376,Spring,Wednesday,Work
2012-01-19,1,4,1,130,3162,3292,Spring,Thursday,Work
2012-01-20,1,5,1,115,3048,3163,Spring,Friday,Work
2012-01-21,1,6,0,67,1234,1301,Spring,Saturday,Holiday
2012-01-22,1,0,0,196,1781,1977,Spring,Sunday,Holiday
2012-01-23,1,1,1,145,2287,2432,Spring,Monday,Work
2012-01-24,1,2,1,439,3900,4339,Spring,Tuesday,Work
2012-01-25,1,3,1,467,3803,4270,Spring,Wednesday,Work
2012-01-26,1,4,1,244,3831,4075,Spring,Thursday,Work
2012-01-27,1,5,1,269,3187,3456,Spring,Friday,Work
2012-01-28,1,6,0,775,3248,4023,Spring,Saturday,Holiday
2012-01-29,1,0,0,558,2685,3243,Spring,Sunday,Holiday
2012-01-30,1,1,1,126,3498,3624,Spring,Monday,Work
2012-01-31,1,2,1,324,4185,4509,Spring,Tuesday,Work
2012-02-01,1,3,1,304,4275,4579,Spring,Wednesday,Work
2012-02-02,1,4,1,190,3571,3761,Spring,Thursday,Work
2012-02-03,1,5,1,310,3841,4151,Spring,Friday,Work
2012-02-04,1,6,0,384,2448,2832,Spring,Saturday,Holiday
2012-02-05,1,0,0,318,2629,2947,Spring,Sunday,Holiday
2012-02-06,1,1,1,206,3578,3784,Spring,Monday,Work
2012-02-07,1,2,1,199,4176,4375,Spring,Tuesday,Work
2012-02-08,1,3,1,109,2693,2802,Spring,Wednesday,Work
2012-02-09,1,4,1,163,3667,3830,Spring,Thursday,Work
2012-02-10,1,5,1,227,3604,3831,Spring,Friday,Work
2012-02-11,1,6,0,192,1977,2169,Spring,Saturday,Holiday
2012-02-12,1,0,0,73,1456,1529,Spring,Sunday,Holiday
2012-02-13,1,1,1,94,3328,3422,Spring,Monday,Work
2012-02-14,1,2,1,135,3787,3922,Spring,Tuesday,Work
2012-02-15,1,3,1,141,4028,4169,Spring,Wednesday,Work
2012-02-16,1,4,1,74,2931,3005,Spring,Thursday,Work
2012-02-17,1,5,1,349,3805,4154,Spring,Friday,Work
2012-02-18,1,6,0,1435,2883,4318,Spring,Saturday,Holiday
2012-02-19,1,0,0,618,2071,2689,Spring,Sunday,Holiday
2012-02-20,1,1,0,502,2627,3129,Spring,Monday,Holiday
2012-02-21,1,2,1,163,3614,3777,Spring,Tuesday,Work
2012-02-22,1,3,1,394,4379,4773,Spring,Wednesday,Work
2012-02-23,1,4,1,516,4546,5062,Spring,Thursday,Work
2012-02-24,1,5,1,246,3241,3487,Spring,Friday,Work
2012-02-25,1,6,0,317,2415,2732,Spring,Saturday,Holiday
2012-02-26,1,0,0,515,2874,3389,Spring,Sunday,Holiday
2012-02-27,1,1,1,253,4069,4322,Spring,Monday,Work
2012-02-28,1,2,1,229,4134,4363,Spring,Tuesday,Work
2012-02-29,1,3,1,65,1769,1834,Spring,Wednesday,Work
2012-03-01,1,4,1,325,4665,4990,Spring,Thursday,Work
2012-03-02,1,5,1,246,2948,3194,Spring,Friday,Work
2012-03-03,1,6,0,956,3110,4066,Spring,Saturday,Holiday
2012-03-04,1,0,0,710,2713,3423,Spring,Sunday,Holiday
2012-03-05,1,1,1,203,3130,3333,Spring,Monday,Work
2012-03-06,1,2,1,221,3735,3956,Spring,Tuesday,Work
2012-03-07,1,3,1,432,4484,4916,Spring,Wednesday,Work
2012-03-08,1,4,1,486,4896,5382,Spring,Thursday,Work
2012-03-09,1,5,1,447,4122,4569,Spring,Friday,Work
2012-03-10,1,6,0,968,3150,4118,Spring,Saturday,Holiday
2012-03-11,1,0,0,1658,3253,4911,Spring,Sunday,Holiday
2012-03-12,1,1,1,838,4460,5298,Spring,Monday,Work
2012-03-13,1,2,1,762,5085,5847,Spring,Tuesday,Work
2012-03-14,1,3,1,997,5315,6312,Spring,Wednesday,Work
2012-03-15,1,4,1,1005,5187,6192,Spring,Thursday,Work
2012-03-16,1,5,1,548,3830,4378,Spring,Friday,Work
2012-03-17,1,6,0,3155,4681,7836,Spring,Saturday,Holiday
2012-03-18,1,0,0,2207,3685,5892,Spring,Sunday,Holiday
2012-03-19,1,1,1,982,5171,6153,Spring,Monday,Work
2012-03-20,1,2,1,1051,5042,6093,Spring,Tuesday,Work
2012-03-21,2,3,1,1122,5108,6230,Summer,Wednesday,Work
2012-03-22,2,4,1,1334,5537,6871,Summer,Thursday,Work
2012-03-23,2,5,1,2469,5893,8362,Summer,Friday,Work
2012-03-24,2,6,0,1033,2339,3372,Summer,Saturday,Holiday
2012-03-25,2,0,0,1532,3464,4996,Summer,Sunday,Holiday
2012-03-26,2,1,1,795,4763,5558,Summer,Monday,Work
2012-03-27,2,2,1,531,4571,5102,Summer,Tuesday,Work
2012-03-28,2,3,1,674,5024,5698,Summer,Wednesday,Work
2012-03-29,2,4,1,834,5299,6133,Summer,Thursday,Work
2012-03-30,2,5,1,796,4663,5459,Summer,Friday,Work
2012-03-31,2,6,0,2301,3934,6235,Summer,Saturday,Holiday
2012-04-01,2,0,0,2347,3694,6041,Summer,Sunday,Holiday
2012-04-02,2,1,1,1208,4728,5936,Summer,Monday,Work
2012-04-03,2,2,1,1348,5424,6772,Summer,Tuesday,Work
2012-04-04,2,3,1,1058,5378,6436,Summer,Wednesday,Work
2012-04-05,2,4,1,1192,5265,6457,Summer,Thursday,Work
2012-04-06,2,5,1,1807,4653,6460,Summer,Friday,Work
2012-04-07,2,6,0,3252,3605,6857,Summer,Saturday,Holiday
2012-04-08,2,0,0,2230,2939,5169,Summer,Sunday,Holiday
2012-04-09,2,1,1,905,4680,5585,Summer,Monday,Work
2012-04-10,2,2,1,819,5099,5918,Summer,Tuesday,Work
2012-04-11,2,3,1,482,4380,4862,Summer,Wednesday,Work
2012-04-12,2,4,1,663,4746,5409,Summer,Thursday,Work
2012-04-13,2,5,1,1252,5146,6398,Summer,Friday,Work
2012-04-14,2,6,0,2795,4665,7460,Summer,Saturday,Holiday
2012-04-15,2,0,0,2846,4286,7132,Summer,Sunday,Holiday
2012-04-16,2,1,0,1198,5172,6370,Summer,Monday,Holiday
2012-04-17,2,2,1,989,5702,6691,Summer,Tuesday,Work
2012-04-18,2,3,1,347,4020,4367,Summer,Wednesday,Work
2012-04-19,2,4,1,846,5719,6565,Summer,Thursday,Work
2012-04-20,2,5,1,1340,5950,7290,Summer,Friday,Work
2012-04-21,2,6,0,2541,4083,6624,Summer,Saturday,Holiday
2012-04-22,2,0,0,120,907,1027,Summer,Sunday,Holiday
2012-04-23,2,1,1,195,3019,3214,Summer,Monday,Work
2012-04-24,2,2,1,518,5115,5633,Summer,Tuesday,Work
2012-04-25,2,3,1,655,5541,6196,Summer,Wednesday,Work
2012-04-26,2,4,1,475,4551,5026,Summer,Thursday,Work
2012-04-27,2,5,1,1014,5219,6233,Summer,Friday,Work
2012-04-28,2,6,0,1120,3100,4220,Summer,Saturday,Holiday
2012-04-29,2,0,0,2229,4075,6304,Summer,Sunday,Holiday
2012-04-30,2,1,1,665,4907,5572,Summer,Monday,Work
2012-05-01,2,2,1,653,5087,5740,Summer,Tuesday,Work
2012-05-02,2,3,1,667,5502,6169,Summer,Wednesday,Work
2012-05-03,2,4,1,764,5657,6421,Summer,Thursday,Work
2012-05-04,2,5,1,1069,5227,6296,Summer,Friday,Work
2012-05-05,2,6,0,2496,4387,6883,Summer,Saturday,Holiday
2012-05-06,2,0,0,2135,4224,6359,Summer,Sunday,Holiday
2012-05-07,2,1,1,1008,5265,6273,Summer,Monday,Work
2012-05-08,2,2,1,738,4990,5728,Summer,Tuesday,Work
2012-05-09,2,3,1,620,4097,4717,Summer,Wednesday,Work
2012-05-10,2,4,1,1026,5546,6572,Summer,Thursday,Work
2012-05-11,2,5,1,1319,5711,7030,Summer,Friday,Work
2012-05-12,2,6,0,2622,4807,7429,Summer,Saturday,Holiday
2012-05-13,2,0,0,2172,3946,6118,Summer,Sunday,Holiday
2012-05-14,2,1,1,342,2501,2843,Summer,Monday,Work
2012-05-15,2,2,1,625,4490,5115,Summer,Tuesday,Work
2012-05-16,2,3,1,991,6433,7424,Summer,Wednesday,Work
2012-05-17,2,4,1,1242,6142,7384,Summer,Thursday,Work
2012-05-18,2,5,1,1521,6118,7639,Summer,Friday,Work
2012-05-19,2,6,0,3410,4884,8294,Summer,Saturday,Holiday
2012-05-20,2,0,0,2704,4425,7129,Summer,Sunday,Holiday
2012-05-21,2,1,1,630,3729,4359,Summer,Monday,Work
2012-05-22,2,2,1,819,5254,6073,Summer,Tuesday,Work
2012-05-23,2,3,1,766,4494,5260,Summer,Wednesday,Work
2012-05-24,2,4,1,1059,5711,6770,Summer,Thursday,Work
2012-05-25,2,5,1,1417,5317,6734,Summer,Friday,Work
2012-05-26,2,6,0,2855,3681,6536,Summer,Saturday,Holiday
2012-05-27,2,0,0,3283,3308,6591,Summer,Sunday,Holiday
2012-05-28,2,1,0,2557,3486,6043,Summer,Monday,Holiday
2012-05-29,2,2,1,880,4863,5743,Summer,Tuesday,Work
2012-05-30,2,3,1,745,6110,6855,Summer,Wednesday,Work
2012-05-31,2,4,1,1100,6238,7338,Summer,Thursday,Work
2012-06-01,2,5,1,533,3594,4127,Summer,Friday,Work
2012-06-02,2,6,0,2795,5325,8120,Summer,Saturday,Holiday
2012-06-03,2,0,0,2494,5147,7641,Summer,Sunday,Holiday
2012-06-04,2,1,1,1071,5927,6998,Summer,Monday,Work
2012-06-05,2,2,1,968,6033,7001,Summer,Tuesday,Work
2012-06-06,2,3,1,1027,6028,7055,Summer,Wednesday,Work
2012-06-07,2,4,1,1038,6456,7494,Summer,Thursday,Work
2012-06-08,2,5,1,1488,6248,7736,Summer,Friday,Work
2012-06-09,2,6,0,2708,4790,7498,Summer,Saturday,Holiday
2012-06-10,2,0,0,2224,4374,6598,Summer,Sunday,Holiday
2012-06-11,2,1,1,1017,5647,6664,Summer,Monday,Work
2012-06-12,2,2,1,477,4495,4972,Summer,Tuesday,Work
2012-06-13,2,3,1,1173,6248,7421,Summer,Wednesday,Work
2012-06-14,2,4,1,1180,6183,7363,Summer,Thursday,Work
2012-06-15,2,5,1,1563,6102,7665,Summer,Friday,Work
2012-06-16,2,6,0,2963,4739,7702,Summer,Saturday,Holiday
2012-06-17,2,0,0,2634,4344,6978,Summer,Sunday,Holiday
2012-06-18,2,1,1,653,4446,5099,Summer,Monday,Work
2012-06-19,2,2,1,968,5857,6825,Summer,Tuesday,Work
2012-06-20,2,3,1,872,5339,6211,Summer,Wednesday,Work
2012-06-21,3,4,1,778,5127,5905,Fall,Thursday,Work
2012-06-22,3,5,1,964,4859,5823,Fall,Friday,Work
2012-06-23,3,6,0,2657,4801,7458,Fall,Saturday,Holiday
2012-06-24,3,0,0,2551,4340,6891,Fall,Sunday,Holiday
2012-06-25,3,1,1,1139,5640,6779,Fall,Monday,Work
2012-06-26,3,2,1,1077,6365,7442,Fall,Tuesday,Work
2012-06-27,3,3,1,1077,6258,7335,Fall,Wednesday,Work
2012-06-28,3,4,1,921,5958,6879,Fall,Thursday,Work
2012-06-29,3,5,1,829,4634,5463,Fall,Friday,Work
2012-06-30,3,6,0,1455,4232,5687,Fall,Saturday,Holiday
2012-07-01,3,0,0,1421,4110,5531,Fall,Sunday,Holiday
2012-07-02,3,1,1,904,5323,6227,Fall,Monday,Work
2012-07-03,3,2,1,1052,5608,6660,Fall,Tuesday,Work
2012-07-04,3,3,0,2562,4841,7403,Fall,Wednesday,Holiday
2012-07-05,3,4,1,1405,4836,6241,Fall,Thursday,Work
2012-07-06,3,5,1,1366,4841,6207,Fall,Friday,Work
2012-07-07,3,6,0,1448,3392,4840,Fall,Saturday,Holiday
2012-07-08,3,0,0,1203,3469,4672,Fall,Sunday,Holiday
2012-07-09,3,1,1,998,5571,6569,Fall,Monday,Work
2012-07-10,3,2,1,954,5336,6290,Fall,Tuesday,Work
2012-07-11,3,3,1,975,6289,7264,Fall,Wednesday,Work
2012-07-12,3,4,1,1032,6414,7446,Fall,Thursday,Work
2012-07-13,3,5,1,1511,5988,7499,Fall,Friday,Work
2012-07-14,3,6,0,2355,4614,6969,Fall,Saturday,Holiday
2012-07-15,3,0,0,1920,4111,6031,Fall,Sunday,Holiday
2012-07-16,3,1,1,1088,5742,6830,Fall,Monday,Work
2012-07-17,3,2,1,921,5865,6786,Fall,Tuesday,Work
2012-07-18,3,3,1,799,4914,5713,Fall,Wednesday,Work
2012-07-19,3,4,1,888,5703,6591,Fall,Thursday,Work
2012-07-20,3,5,1,747,5123,5870,Fall,Friday,Work
2012-07-21,3,6,0,1264,3195,4459,Fall,Saturday,Holiday
2012-07-22,3,0,0,2544,4866,7410,Fall,Sunday,Holiday
2012-07-23,3,1,1,1135,5831,6966,Fall,Monday,Work
2012-07-24,3,2,1,1140,6452,7592,Fall,Tuesday,Work
2012-07-25,3,3,1,1383,6790,8173,Fall,Wednesday,Work
2012-07-26,3,4,1,1036,5825,6861,Fall,Thursday,Work
2012-07-27,3,5,1,1259,5645,6904,Fall,Friday,Work
2012-07-28,3,6,0,2234,4451,6685,Fall,Saturday,Holiday
2012-07-29,3,0,0,2153,4444,6597,Fall,Sunday,Holiday
2012-07-30,3,1,1,1040,6065,7105,Fall,Monday,Work
2012-07-31,3,2,1,968,6248,7216,Fall,Tuesday,Work
2012-08-01,3,3,1,1074,6506,7580,Fall,Wednesday,Work
2012-08-02,3,4,1,983,6278,7261,Fall,Thursday,Work
2012-08-03,3,5,1,1328,5847,7175,Fall,Friday,Work
2012-08-04,3,6,0,2345,4479,6824,Fall,Saturday,Holiday
2012-08-05,3,0,0,1707,3757,5464,Fall,Sunday,Holiday
2012-08-06,3,1,1,1233,5780,7013,Fall,Monday,Work
2012-08-07,3,2,1,1278,5995,7273,Fall,Tuesday,Work
2012-08-08,3,3,1,1263,6271,7534,Fall,Wednesday,Work
2012-08-09,3,4,1,1196,6090,7286,Fall,Thursday,Work
2012-08-10,3,5,1,1065,4721,5786,Fall,Friday,Work
2012-08-11,3,6,0,2247,4052,6299,Fall,Saturday,Holiday
2012-08-12,3,0,0,2182,4362,6544,Fall,Sunday,Holiday
2012-08-13,3,1,1,1207,5676,6883,Fall,Monday,Work
2012-08-14,3,2,1,1128,5656,6784,Fall,Tuesday,Work
2012-08-15,3,3,1,1198,6149,7347,Fall,Wednesday,Work
2012-08-16,3,4,1,1338,6267,7605,Fall,Thursday,Work
2012-08-17,3,5,1,1483,5665,7148,Fall,Friday,Work
2012-08-18,3,6,0,2827,5038,7865,Fall,Saturday,Holiday
2012-08-19,3,0,0,1208,3341,4549,Fall,Sunday,Holiday
2012-08-20,3,1,1,1026,5504,6530,Fall,Monday,Work
2012-08-21,3,2,1,1081,5925,7006,Fall,Tuesday,Work
2012-08-22,3,3,1,1094,6281,7375,Fall,Wednesday,Work
2012-08-23,3,4,1,1363,6402,7765,Fall,Thursday,Work
2012-08-24,3,5,1,1325,6257,7582,Fall,Friday,Work
2012-08-25,3,6,0,1829,4224,6053,Fall,Saturday,Holiday
2012-08-26,3,0,0,1483,3772,5255,Fall,Sunday,Holiday
2012-08-27,3,1,1,989,5928,6917,Fall,Monday,Work
2012-08-28,3,2,1,935,6105,7040,Fall,Tuesday,Work
2012-08-29,3,3,1,1177,6520,7697,Fall,Wednesday,Work
2012-08-30,3,4,1,1172,6541,7713,Fall,Thursday,Work
2012-08-31,3,5,1,1433,5917,7350,Fall,Friday,Work
2012-09-01,3,6,0,2352,3788,6140,Fall,Saturday,Holiday
2012-09-02,3,0,0,2613,3197,5810,Fall,Sunday,Holiday
2012-09-03,3,1,0,1965,4069,6034,Fall,Monday,Holiday
2012-09-04,3,2,1,867,5997,6864,Fall,Tuesday,Work
2012-09-05,3,3,1,832,6280,7112,Fall,Wednesday,Work
2012-09-06,3,4,1,611,5592,6203,Fall,Thursday,Work
2012-09-07,3,5,1,1045,6459,7504,Fall,Friday,Work
2012-09-08,3,6,0,1557,4419,5976,Fall,Saturday,Holiday
2012-09-09,3,0,0,2570,5657,8227,Fall,Sunday,Holiday
2012-09-10,3,1,1,1118,6407,7525,Fall,Monday,Work
2012-09-11,3,2,1,1070,6697,7767,Fall,Tuesday,Work
2012-09-12,3,3,1,1050,6820,7870,Fall,Wednesday,Work
2012-09-13,3,4,1,1054,6750,7804,Fall,Thursday,Work
2012-09-14,3,5,1,1379,6630,8009,Fall,Friday,Work
2012-09-15,3,6,0,3160,5554,8714,Fall,Saturday,Holiday
2012-09-16,3,0,0,2166,5167,7333,Fall,Sunday,Holiday
2012-09-17,3,1,1,1022,5847,6869,Fall,Monday,Work
2012-09-18,3,2,1,371,3702,4073,Fall,Tuesday,Work
2012-09-19,3,3,1,788,6803,7591,Fall,Wednesday,Work
2012-09-20,3,4,1,939,6781,7720,Fall,Thursday,Work
2012-09-21,3,5,1,1250,6917,8167,Fall,Friday,Work
2012-09-22,3,6,0,2512,5883,8395,Fall,Saturday,Holiday
2012-09-23,4,0,0,2454,5453,7907,Winter,Sunday,Holiday
2012-09-24,4,1,1,1001,6435,7436,Winter,Monday,Work
2012-09-25,4,2,1,845,6693,7538,Winter,Tuesday,Work
2012-09-26,4,3,1,787,6946,7733,Winter,Wednesday,Work
2012-09-27,4,4,1,751,6642,7393,Winter,Thursday,Work
2012-09-28,4,5,1,1045,6370,7415,Winter,Friday,Work
2012-09-29,4,6,0,2589,5966,8555,Winter,Saturday,Holiday
2012-09-30,4,0,0,2015,4874,6889,Winter,Sunday,Holiday
2012-10-01,4,1,1,763,6015,6778,Winter,Monday,Work
2012-10-02,4,2,1,315,4324,4639,Winter,Tuesday,Work
2012-10-03,4,3,1,728,6844,7572,Winter,Wednesday,Work
2012-10-04,4,4,1,891,6437,7328,Winter,Thursday,Work
2012-10-05,4,5,1,1516,6640,8156,Winter,Friday,Work
2012-10-06,4,6,0,3031,4934,7965,Winter,Saturday,Holiday
2012-10-07,4,0,0,781,2729,3510,Winter,Sunday,Holiday
2012-10-08,4,1,0,874,4604,5478,Winter,Monday,Holiday
2012-10-09,4,2,1,601,5791,6392,Winter,Tuesday,Work
2012-10-10,4,3,1,780,6911,7691,Winter,Wednesday,Work
2012-10-11,4,4,1,834,6736,7570,Winter,Thursday,Work
2012-10-12,4,5,1,1060,6222,7282,Winter,Friday,Work
2012-10-13,4,6,0,2252,4857,7109,Winter,Saturday,Holiday
2012-10-14,4,0,0,2080,4559,6639,Winter,Sunday,Holiday
2012-10-15,4,1,1,760,5115,5875,Winter,Monday,Work
2012-10-16,4,2,1,922,6612,7534,Winter,Tuesday,Work
2012-10-17,4,3,1,979,6482,7461,Winter,Wednesday,Work
2012-10-18,4,4,1,1008,6501,7509,Winter,Thursday,Work
2012-10-19,4,5,1,753,4671,5424,Winter,Friday,Work
2012-10-20,4,6,0,2806,5284,8090,Winter,Saturday,Holiday
2012-10-21,4,0,0,2132,4692,6824,Winter,Sunday,Holiday
2012-10-22,4,1,1,830,6228,7058,Winter,Monday,Work
2012-10-23,4,2,1,841,6625,7466,Winter,Tuesday,Work
2012-10-24,4,3,1,795,6898,7693,Winter,Wednesday,Work
2012-10-25,4,4,1,875,6484,7359,Winter,Thursday,Work
2012-10-26,4,5,1,1182,6262,7444,Winter,Friday,Work
2012-10-27,4,6,0,2643,5209,7852,Winter,Saturday,Holiday
2012-10-28,4,0,0,998,3461,4459,Winter,Sunday,Holiday
2012-10-29,4,1,1,2,20,22,Winter,Monday,Work
2012-10-30,4,2,1,87,1009,1096,Winter,Tuesday,Work
2012-10-31,4,3,1,419,5147,5566,Winter,Wednesday,Work
2012-11-01,4,4,1,466,5520,5986,Winter,Thursday,Work
2012-11-02,4,5,1,618,5229,5847,Winter,Friday,Work
2012-11-03,4,6,0,1029,4109,5138,Winter,Saturday,Holiday
2012-11-04,4,0,0,1201,3906,5107,Winter,Sunday,Holiday
2012-11-05,4,1,1,378,4881,5259,Winter,Monday,Work
2012-11-06,4,2,1,466,5220,5686,Winter,Tuesday,Work
2012-11-07,4,3,1,326,4709,5035,Winter,Wednesday,Work
2012-11-08,4,4,1,340,4975,5315,Winter,Thursday,Work
2012-11-09,4,5,1,709,5283,5992,Winter,Friday,Work
2012-11-10,4,6,0,2090,4446,6536,Winter,Saturday,Holiday
2012-11-11,4,0,0,2290,4562,6852,Winter,Sunday,Holiday
2012-11-12,4,1,0,1097,5172,6269,Winter,Monday,Holiday
2012-11-13,4,2,1,327,3767,4094,Winter,Tuesday,Work
2012-11-14,4,3,1,373,5122,5495,Winter,Wednesday,Work
2012-11-15,4,4,1,320,5125,5445,Winter,Thursday,Work
2012-11-16,4,5,1,484,5214,5698,Winter,Friday,Work
2012-11-17,4,6,0,1313,4316,5629,Winter,Saturday,Holiday
2012-11-18,4,0,0,922,3747,4669,Winter,Sunday,Holiday
2012-11-19,4,1,1,449,5050,5499,Winter,Monday,Work
2012-11-20,4,2,1,534,5100,5634,Winter,Tuesday,Work
2012-11-21,4,3,1,615,4531,5146,Winter,Wednesday,Work
2012-11-22,4,4,0,955,1470,2425,Winter,Thursday,Holiday
2012-11-23,4,5,1,1603,2307,3910,Winter,Friday,Work
2012-11-24,4,6,0,532,1745,2277,Winter,Saturday,Holiday
2012-11-25,4,0,0,309,2115,2424,Winter,Sunday,Holiday
2012-11-26,4,1,1,337,4750,5087,Winter,Monday,Work
2012-11-27,4,2,1,123,3836,3959,Winter,Tuesday,Work
2012-11-28,4,3,1,198,5062,5260,Winter,Wednesday,Work
2012-11-29,4,4,1,243,5080,5323,Winter,Thursday,Work
2012-11-30,4,5,1,362,5306,5668,Winter,Friday,Work
2012-12-01,4,6,0,951,4240,5191,Winter,Saturday,Holiday
2012-12-02,4,0,0,892,3757,4649,Winter,Sunday,Holiday
2012-12-03,4,1,1,555,5679,6234,Winter,Monday,Work
2012-12-04,4,2,1,551,6055,6606,Winter,Tuesday,Work
2012-12-05,4,3,1,331,5398,5729,Winter,Wednesday,Work
2012-12-06,4,4,1,340,5035,5375,Winter,Thursday,Work
2012-12-07,4,5,1,349,4659,5008,Winter,Friday,Work
2012-12-08,4,6,0,1153,4429,5582,Winter,Saturday,Holiday
2012-12-09,4,0,0,441,2787,3228,Winter,Sunday,Holiday
2012-12-10,4,1,1,329,4841,5170,Winter,Monday,Work
2012-12-11,4,2,1,282,5219,5501,Winter,Tuesday,Work
2012-12-12,4,3,1,310,5009,5319,Winter,Wednesday,Work
2012-12-13,4,4,1,425,5107,5532,Winter,Thursday,Work
2012-12-14,4,5,1,429,5182,5611,Winter,Friday,Work
2012-12-15,4,6,0,767,4280,5047,Winter,Saturday,Holiday
2012-12-16,4,0,0,538,3248,3786,Winter,Sunday,Holiday
2012-12-17,4,1,1,212,4373,4585,Winter,Monday,Work
2012-12-18,4,2,1,433,5124,5557,Winter,Tuesday,Work
2012-12-19,4,3,1,333,4934,5267,Winter,Wednesday,Work
2012-12-20,4,4,1,314,3814,4128,Winter,Thursday,Work
2012-12-21,1,5,1,221,3402,3623,Spring,Friday,Work
2012-12-22,1,6,0,205,1544,1749,Spring,Saturday,Holiday
2012-12-23,1,0,0,408,1379,1787,Spring,Sunday,Holiday
2012-12-24,1,1,1,174,746,920,Spring,Monday,Work
2012-12-25,1,2,0,440,573,1013,Spring,Tuesday,Holiday
2012-12-26,1,3,1,9,432,441,Spring,Wednesday,Work
2012-12-27,1,4,1,247,1867,2114,Spring,Thursday,Work
2012-12-28,1,5,1,644,2451,3095,Spring,Friday,Work
2012-12-29,1,6,0,159,1182,1341,Spring,Saturday,Holiday
2012-12-30,1,0,0,364,1432,1796,Spring,Sunday,Holiday
2012-12-31,1,1,1,439,2290,2729,Spring,Monday,Work
